6 6
2 3
1 3
111111
110111
111111
1**101
110101
111111
