10 10
8 6
6 6
1111111111
1110101011
1011000001
1101001111
1010100001
1101111111
101010*0*1
1011101111
1011101111
1111111111
